**********_******_***
*--i--|*--I--|*--A--|
***_******_******_***
**********_******_***
|--X--||--H--||--E--|
***_******_******_***
**********_******_***
|--P--||--M--||--o--|
***_******_******_***
