* * * * * * * * * * * * * * * * * * * * * * * * * * * * * * * * * * * * * * * * * * * * * * * *
* * * * * * * * * * * * * * * * * * * * * * * * * * * * * * * * * * * * * * * * * * * * * * * *
* - - - - * - - - - - * - - - * * - - - - * - - - - - * - - - * * - - - - * - - - - - * - - - *
* - - - - - - - - - - - - - - * * - - - - - - - - - - - - - - * * - - - - - - - - - - - - - - *
* - - - - * - - - - - * - - - * * - - - - * - - - - - * - - - * * - - - - * - - - - - * - - - *
* * * - * * * * - * * * * * * * * * * - * * * * - * * * * * * * * * * - * * * * - * * * * * * *
- - - - - - - - - - - - - - - - - - - - - - - - - - - - - - - - - - - - - - - - - - - - - - - -
* * * - * * * * - * * * * * * * * * * - * * * * - * * * * * * * * * * - * * * * - * * * * * * *
* - - - - * - - - - - * - - - * * - - - - * - - - - - * - - - * * - - - - * - - - - - * - - - *
* - - - - - - - - - - - - - - * * - - - - - - - - - - - - - - * * - - - - - - - - - - - - - - *
* - - - - * - - - - - * - - - * * - - - - * - - - - - * - - - * * - - - - * - - - - - * - - - *
* - - - - * - - - - - * - - - * * - - - - * - - - - - * - - - * * - - - - * - - - - - * - - - *
* * * * * * * * * * * * * * * * * * * * * * * * * * * * * * * * * * * * * * * * * * * * * * * *
* * * * * * * * * * * * * * * * * * * * * * * * * * * * * * * * * * * * * * * * * * * * * * * *
* - - - - * - - - - - * - - - * * - - - - * - - - - - * - - - * * - - - - * - - - - - * - - - *
* - - - - - - - - - - - - - - * * - - - - - - - - - - - - - - * * - - - - - - - - - - - - - - *
* - - - - * - - - - - * - - - * * - - - - * - - - - - * - - - * * - - - - * - - - - - * - - - *
* * * - * * * * - * * * * * * * * * * - * * * * - * * * * * * * * * * - * * * * - * * * * * * *
- - - - - - - - - - - - - - - - - - - - - - - - - - - - - - - - - - - - - - - - - - - - - - - -
* * * - * * * * - * * * * * * * * * * - * * * * - * * * * * * * * * * - * * * * - * * * * * * *
* - - - - * - - - - - * - - - * * - - - - * - - - - - * - - - * * - - - - * - - - - - * - - - *
* - - - - - - - - - - - - - - * * - - - - - - - - - - - - - - * * - - - - - - - - - - - - - - *
* - - - - * - - - - - * - - - * * - - - - * - - - - - * - - - * * - - - - * - - - - - * - - - *
* * * * * * * * * * * * * * * * * * * * * * * * * * * * * * * * * * * * * * * * * * * * * * * *