* * * * * * * * * * * * * * * 
* - - - * * - - - * * - - - * 
* - H - D D - A - D D - o - * 
* - - - * * - - - * * - - - * 
* * D * * * * D * * * * D * * 
* * D * * * * D * * * * D * * 
* - - - * * - - - * * - - - * 
* - P - D D - H - D D - H - * 
* - - - * * - - - * * - - - * 
* * D * * * * D * * * * D * * 
* * D * * * * D * * * * D * * 
* - - - * * - - - * * - - - * 
* - I - D D - E - D D - i - * 
* - - - * * - - - * * - - - * 
* * * * * * * * * * * * * * * 
