* * * * * * * * * * * * * * * 
* - - - * * - - - * * - - - * 
* - X - D D - P - D D - V - * 
* - - - * * - - - * * - - - * 
* * D * * * * D * * * * D * * 
* * D * * * * D * * * * D * * 
* - - - * * - - - * * - - - * 
* - i - D D - E - D D - I - * 
* - - - * * - - - * * - - - * 
* * D * * * * D * * * * D * * 
* * D * * * * D * * * * D * * 
* - - - * * - - - * * - - - * 
* - X - D D - A - D D - o - * 
* - - - * * - - - * * - - - * 
* * * * * * * * * * * * * * * 
