* * * * * * * * * * * * * * * 
* O - - * * - - - * * - - - * 
* - H - D D - o - D D - A - * 
* - - - * * - - - * * - - - * 
* * D * * * * D * * * * D * * 
* * D * * * * D * * * * D * * 
* - - - * * - - - * * - - - * 
* - P - D D - X - D D - V - * 
* - - - * * - - - * * - - - * 
* * D * * * * D * * * * D * * 
* * D * * * * D * * * * D * * 
* O - - * * - - - * * - - - * 
* - I - D D - E - D D - i - * 
* - - - * * - - - * * - - - * 
* * * * * * * * * * * * * * * 
