* * * * * * * * * * * * * * * * * * * * * * * * * * * * * * * * * * * * * * * * 
* - - - * * - - - * * - - - * * - - - * * - - - * * - - - * * - - - * * - - - * 
* - i - D D - X - D D - H - D D - V - D D - N - D D - M - D D - H - D D - V - * 
* - - - * * - - - * * - - - * * - - - * * - - - * * - - - * * - - - * * - - - * 
* * D * * * * D * * * * D * * * * D * * * * D * * * * D * * * * D * * * * D * * 
* * D * * * * D * * * * D * * * * D * * * * D * * * * D * * * * D * * * * D * * 
* - - - * * - - - * * - - - * * - - - * * - - - * * - - - * * - - - * * - - - * 
* - X - D D - N - D D - V - D D - P - D D - N - D D - M - D D - N - D D - N - * 
* - - - * * - - - * * - - - * * - - - * * - - - * * - - - * * - - - * * - - - * 
* * D * * * * D * * * * D * * * * D * * * * D * * * * D * * * * D * * * * D * * 
* * D * * * * D * * * * D * * * * D * * * * D * * * * D * * * * D * * * * D * * 
* - - - * * - - - * * - - - * * - - - * * - - - * * - - - * * - - - * * - - - * 
* - H - D D - M - D D - H - D D - V - D D - X - D D - I - D D - N - D D - V - * 
* - - - * * - - - * * - - - * * - - - * * - - - * * - - - * * - - - * * - - - * 
* * D * * * * D * * * * D * * * * D * * * * D * * * * D * * * * D * * * * D * * 
* * D * * * * D * * * * D * * * * D * * * * D * * * * D * * * * D * * * * D * * 
* - - - * * - - - * * - - - * * - - - * * - - - * * - - - * * - - - * * - - - * 
* - H - D D - X - D D - X - D D - X - D D - H - D D - H - D D - V - D D - X - * 
* - - - * * - - - * * - - - * * - - - * * - - - * * - - - * * - - - * * - - - * 
* * D * * * * D * * * * D * * * * D * * * * D * * * * D * * * * D * * * * D * * 
* * D * * * * D * * * * D * * * * D * * * * D * * * * D * * * * D * * * * D * * 
* - - - * * - - - * * - - - * * - - - * * - - - * * - - - * * - - - * * - - - * 
* - V - D D - V - D D - X - D D - V - D D - H - D D - H - D D - A - D D - H - * 
* - - - * * - - - * * - - - * * - - - * * - - - * * - - - * * - - - * * - - - * 
* * D * * * * D * * * * D * * * * D * * * * D * * * * D * * * * D * * * * D * * 
* * D * * * * D * * * * D * * * * D * * * * D * * * * D * * * * D * * * * D * * 
* - - - * * - - - * * - - - * * - - - * * - - - * * - - - * * - - - * * - - - * 
* - H - D D - H - D D - N - D D - M - D D - H - D D - H - D D - E - D D - X - * 
* - - - * * - - - * * - - - * * - - - * * - - - * * - - - * * - - - * * - - - * 
* * D * * * * D * * * * D * * * * D * * * * D * * * * D * * * * D * * * * D * * 
* * D * * * * D * * * * D * * * * D * * * * D * * * * D * * * * D * * * * D * * 
* - - - * * - - - * * - - - * * - - - * * - - - * * - - - * * - - - * * - - - * 
* - N - D D - V - D D - X - D D - H - D D - N - D D - N - D D - H - D D - N - * 
* - - - * * - - - * * - - - * * - - - * * - - - * * - - - * * - - - * * - - - * 
* * D * * * * D * * * * D * * * * D * * * * D * * * * D * * * * D * * * * D * * 
* * D * * * * D * * * * D * * * * D * * * * D * * * * D * * * * D * * * * D * * 
* - - - * * - - - * * - - - * * - - - * * - - - * * - - - * * - - - * * - - - * 
* - M - D D - M - D D - V - D D - H - D D - X - D D - X - D D - H - D D - o - * 
* - - - * * - - - * * - - - * * - - - * * - - - * * - - - * * - - - * * - - - * 
* * * * * * * * * * * * * * * * * * * * * * * * * * * * * * * * * * * * * * * * 
