* * * * * * * * * * * * * * * 
* - - - * * - - - * * - - - * 
* - V - D D - X - D D - i - * 
* - - - * * - - - * * - - - * 
* * D * * * * D * * * * D * * 
* * D * * * * D * * * * D * * 
* - - - * * - - - * * - - - * 
* - A - D D - X - D D - I - * 
* - - - * * - - - * * - - - * 
* * D * * * * D * * * * D * * 
* * D * * * * D * * * * D * * 
* - - - * * - - - * * - - - * 
* - P - D D - o - D D - E - * 
* - - - * * - - - * * - - - * 
* * * * * * * * * * * * * * * 
