* * * * * * * * * * * * * * * 
* - - - * * - - - * * - - - * 
* - I - D D - o - D D - V - * 
* - - - * * - - - * * - - - * 
* * D * * * * D * * * * D * * 
* * D * * * * D * * * * D * * 
* - - - * * - - - * * - - - * 
* - X - D D - V - D D - P - * 
* - - - * * - - - * * - - - * 
* * D * * * * D * * * * D * * 
* * D * * * * D * * * * D * * 
* - - - * * - - - * * - - - * 
* - A - D D - E - D D - i - * 
* - - - * * - - - * * - - - * 
* * * * * * * * * * * * * * * 
