* * * * * * * * * * * * * * * 
* - - - * * - - - * * - - - * 
* - N - D D - A - D D - i - * 
* - - - * * - - - * * - - - * 
* * D * * * * D * * * * D * * 
* * D * * * * D * * * * D * * 
* G - - * * - - - * * - - - * 
* - E - D D - I - D D - H - * 
* - - - * * - - - * * - - - * 
* * D * * * * D * * * * D * * 
* * D * * * * D * * * * D * * 
* G - - * * - - - * * - - - * 
* - P - D D - V - D D - o - * 
* - - - * * - - - * * - - - * 
* * * * * * * * * * * * * * * 
